//MAP CONVERTED BY dmm2tgm.py THIS HEADER COMMENT PREVENTS RECONVERSION, DO NOT REMOVE
"bl" = (
/obj/effect/decal/remains/human,
/turf/open/misc/sandy_dirt,
/area/lavaland/surface/outdoors)
"bv" = (
/obj/effect/decal/cleanable/dirt/dust,
/obj/effect/decal/cleanable/dirt,
/obj/item/defibrillator/loaded{
	pixel_y = 7
	},
/obj/item/emergency_bed{
	pixel_x = 1;
	pixel_y = -4
	},
/turf/open/misc/sandy_dirt,
/area/lavaland/surface/outdoors)
"bT" = (
/obj/effect/decal/cleanable/ash/large,
/obj/effect/decal/cleanable/dirt/dust,
/obj/effect/decal/cleanable/glass,
/turf/open/misc/sandy_dirt,
/area/lavaland/surface/outdoors)
"cz" = (
/obj/effect/light_emitter/fake_outdoors,
/turf/open/floor/grass{
	baseturfs = /turf/open/chasm/jungle
	},
/area/lavaland/surface/outdoors)
"dm" = (
/obj/structure/flora/bush/reed/style_random,
/mob/living/basic/butterfly/lavaland,
/turf/open/water,
/area/lavaland/surface/outdoors)
"dM" = (
/obj/structure/flora/rock/pile/style_random,
/obj/structure/flora/bush/leafy,
/mob/living/basic/butterfly/lavaland,
/turf/open/misc/dirt/jungle/wasteland,
/area/lavaland/surface/outdoors)
"eF" = (
/obj/effect/decal/remains/human,
/turf/open/misc/asteroid/basalt,
/area/lavaland/surface/outdoors)
"eS" = (
/obj/item/storage/medkit,
/obj/effect/decal/cleanable/dirt/dust,
/obj/effect/decal/cleanable/dirt/dust,
/obj/item/storage/medkit{
	pixel_y = 7
	},
/obj/effect/decal/cleanable/wrapping,
/turf/open/misc/sandy_dirt,
/area/lavaland/surface/outdoors)
"fb" = (
/obj/effect/decal/cleanable/dirt/dust,
/turf/open/floor/grass{
	baseturfs = /turf/open/chasm/jungle
	},
/area/lavaland/surface/outdoors)
"fV" = (
/obj/structure/flora/rock/pile/style_random,
/turf/open/water,
/area/lavaland/surface/outdoors)
"gk" = (
/obj/structure/flora/bush/style_random,
/turf/open/floor/grass{
	baseturfs = /turf/open/chasm/jungle
	},
/area/lavaland/surface/outdoors)
"gO" = (
/obj/structure/flora/rock/style_random,
/turf/open/misc/dirt/jungle/wasteland,
/area/lavaland/surface/outdoors)
"hz" = (
/obj/effect/decal/cleanable/glass,
/obj/effect/decal/cleanable/dirt/dust,
/obj/structure/reagent_dispensers/watertank/high,
/turf/open/misc/sandy_dirt,
/area/lavaland/surface/outdoors)
"jg" = (
/turf/closed/mineral/random{
	name = "stone";
	baseturfs = /turf/open/misc/asteroid/basalt;
	initial_gas_mix = "o2=22;n2=82;TEMP=293.15"
	},
/area/lavaland/surface/outdoors)
"kp" = (
/obj/effect/decal/cleanable/dirt/dust,
/turf/open/misc/sandy_dirt,
/area/lavaland/surface/outdoors)
"ky" = (
/obj/effect/decal/cleanable/dirt/dust,
/obj/effect/decal/cleanable/dirt,
/obj/effect/decal/cleanable/ash/large,
/turf/open/misc/sandy_dirt,
/area/lavaland/surface/outdoors)
"kP" = (
/obj/structure/spawner/mining{
	max_mobs = 1;
	name = "bear cave";
	mob_types = list(/mob/living/basic/bear,/mob/living/basic/bear/russian);
	desc = "A beary scary guy lives in here. Watch out for when he's hungry."
	},
/turf/open/misc/sandy_dirt,
/area/lavaland/surface/outdoors)
"me" = (
/obj/effect/decal/cleanable/dirt/dust,
/obj/effect/decal/cleanable/ash,
/turf/open/misc/sandy_dirt,
/area/lavaland/surface/outdoors)
"mf" = (
/obj/effect/decal/cleanable/dirt/dust,
/obj/effect/decal/cleanable/dirt/dust,
/turf/open/floor/grass{
	baseturfs = /turf/open/chasm/jungle
	},
/area/lavaland/surface/outdoors)
"mr" = (
/obj/structure/flora/bush/leafy,
/mob/living/basic/butterfly/lavaland,
/turf/open/misc/dirt/jungle/wasteland,
/area/lavaland/surface/outdoors)
"mF" = (
/obj/structure/spawner/mining{
	max_mobs = 2;
	name = "wolfs den";
	mob_types = list(/mob/living/basic/mining/wolf);
	desc = "A pack of wolves seems to have settled in here."
	},
/turf/open/misc/sandy_dirt,
/area/lavaland/surface/outdoors)
"na" = (
/obj/structure/flora/rock/style_random,
/turf/open/misc/sandy_dirt,
/area/lavaland/surface/outdoors)
"nh" = (
/obj/effect/decal/cleanable/dirt/dust,
/obj/effect/decal/cleanable/dirt/dust,
/obj/effect/decal/cleanable/dirt,
/obj/item/storage/medkit/fire,
/obj/item/storage/medkit/brute{
	pixel_y = 7
	},
/obj/effect/decal/cleanable/wrapping,
/turf/open/misc/sandy_dirt,
/area/lavaland/surface/outdoors)
"oe" = (
/obj/structure/flora/tree/jungle/small/style_random,
/turf/open/floor/grass{
	baseturfs = /turf/open/chasm/jungle
	},
/area/lavaland/surface/outdoors)
"oX" = (
/obj/effect/decal/cleanable/dirt/dust,
/obj/effect/decal/cleanable/dirt/dust,
/obj/effect/decal/cleanable/dirt/dust,
/obj/effect/decal/cleanable/dirt,
/obj/effect/decal/cleanable/dirt,
/obj/structure/closet/supplypod{
	name = "emergency provisions pod"
	},
/turf/open/misc/sandy_dirt,
/area/lavaland/surface/outdoors)
"qJ" = (
/obj/effect/decal/cleanable/ash/large,
/turf/open/misc/sandy_dirt,
/area/lavaland/surface/outdoors)
"qY" = (
/turf/open/misc/sandy_dirt,
/area/lavaland/surface/outdoors)
"rj" = (
/obj/effect/decal/cleanable/dirt/dust,
/obj/item/storage/medkit/toxin,
/obj/item/storage/medkit/surgery{
	pixel_y = 6
	},
/obj/effect/decal/cleanable/dirt,
/obj/effect/decal/cleanable/glass,
/obj/effect/decal/cleanable/insectguts,
/turf/open/misc/sandy_dirt,
/area/lavaland/surface/outdoors)
"sd" = (
/obj/effect/decal/cleanable/dirt/dust,
/obj/item/clothing/gloves/color/yellow{
	pixel_y = 11;
	pixel_x = -2
	},
/obj/effect/decal/cleanable/insectguts,
/obj/item/multitool{
	pixel_y = -5;
	pixel_x = 6
	},
/turf/open/misc/sandy_dirt,
/area/lavaland/surface/outdoors)
"tD" = (
/obj/structure/spawner/mining{
	max_mobs = 1;
	name = "gorilla den";
	mob_types = list(/mob/living/basic/gorilla);
	desc = "A mighty gorilla guards the gate to his people's underground home."
	},
/turf/open/misc/dirt/jungle/wasteland,
/area/lavaland/surface/outdoors)
"up" = (
/obj/structure/flora/tree/jungle/style_random,
/turf/open/floor/grass{
	baseturfs = /turf/open/chasm/jungle
	},
/area/lavaland/surface/outdoors)
"uK" = (
/obj/item/storage/toolbox/guncase/soviet{
	pixel_y = 14;
	pixel_x = -4
	},
/obj/effect/decal/cleanable/dirt/dust,
/obj/effect/decal/cleanable/dirt/dust,
/obj/item/storage/toolbox/ammobox/strilka310{
	pixel_x = 5;
	pixel_y = -1
	},
/obj/item/storage/toolbox/ammobox/strilka310{
	pixel_x = -13;
	pixel_y = -1
	},
/obj/item/storage/toolbox/maint_kit{
	desc = "It contains some gun maintenance supplies"s";
	pixel_y = -8;
	pixel_x = -4
	},
/obj/effect/decal/cleanable/glass,
/turf/open/misc/sandy_dirt,
/area/lavaland/surface/outdoors)
"vb" = (
/obj/structure/flora/rock/pile/style_random,
/turf/open/misc/asteroid/basalt,
/area/lavaland/surface/outdoors)
"vG" = (
/obj/item/clothing/head/helmet/toggleable/riot{
	pixel_y = 8;
	pixel_x = 4
	},
/obj/effect/decal/cleanable/dirt/dust,
/obj/effect/decal/cleanable/dirt/dust,
/obj/item/clothing/suit/armor/vest/alt{
	pixel_y = -8;
	pixel_x = -3
	},
/obj/effect/decal/cleanable/ash/large,
/turf/open/misc/sandy_dirt,
/area/lavaland/surface/outdoors)
"vW" = (
/mob/living/basic/butterfly/lavaland,
/turf/open/water,
/area/lavaland/surface/outdoors)
"wb" = (
/turf/open/misc/asteroid/basalt,
/area/lavaland/surface/outdoors)
"wi" = (
/obj/structure/water_source/puddle,
/turf/open/misc/sandy_dirt,
/area/lavaland/surface/outdoors)
"wW" = (
/obj/effect/decal/cleanable/wrapping,
/obj/effect/decal/cleanable/dirt/dust,
/obj/item/knife/combat{
	dye_color = #36ebff
	},
/obj/effect/decal/cleanable/insectguts,
/turf/open/misc/sandy_dirt,
/area/lavaland/surface/outdoors)
"xb" = (
/obj/effect/decal/cleanable/dirt/dust,
/obj/effect/decal/cleanable/dirt,
/obj/effect/decal/cleanable/wrapping,
/obj/item/food/rationpack,
/obj/item/food/rationpack{
	pixel_y = 4
	},
/obj/item/food/rationpack{
	pixel_y = 7
	},
/obj/effect/decal/cleanable/dirt/dust,
/turf/open/misc/sandy_dirt,
/area/lavaland/surface/outdoors)
"xn" = (
/obj/effect/decal/cleanable/dirt/dust,
/obj/effect/decal/cleanable/dirt/dust,
/obj/item/storage/toolbox/mechanical{
	pixel_y = 5
	},
/obj/item/storage/toolbox/electrical{
	pixel_y = -5
	},
/turf/open/misc/sandy_dirt,
/area/lavaland/surface/outdoors)
"ys" = (
/turf/open/misc/dirt/jungle/wasteland,
/area/lavaland/surface/outdoors)
"zs" = (
/obj/effect/light_emitter/fake_outdoors,
/obj/structure/flora/tree/jungle/small/style_random,
/turf/open/floor/grass{
	baseturfs = /turf/open/chasm/jungle
	},
/area/lavaland/surface/outdoors)
"zJ" = (
/obj/structure/flora/bush/reed/style_random,
/mob/living/basic/butterfly/lavaland,
/mob/living/basic/butterfly/lavaland,
/turf/open/water,
/area/lavaland/surface/outdoors)
"zL" = (
/obj/structure/flora/rock/pile/style_random,
/turf/open/misc/sandy_dirt,
/area/lavaland/surface/outdoors)
"zW" = (
/obj/structure/flora/bush/lavendergrass/style_random,
/turf/open/misc/dirt/dark/station,
/turf/open/misc/sandy_dirt,
/area/lavaland/surface/outdoors)
"Ac" = (
/obj/effect/decal/cleanable/robot_debris,
/turf/open/floor/grass{
	baseturfs = /turf/open/chasm/jungle
	},
/area/lavaland/surface/outdoors)
"Bm" = (
/obj/structure/flora/bush/style_random,
/turf/open/misc/sandy_dirt,
/area/lavaland/surface/outdoors)
"Bs" = (
/obj/structure/flora/bush/leafy,
/mob/living/basic/butterfly/lavaland,
/turf/open/water,
/area/lavaland/surface/outdoors)
"Cb" = (
/obj/effect/decal/cleanable/dirt/dust,
/obj/effect/decal/cleanable/dirt/dust,
/obj/effect/decal/cleanable/dirt/dust,
/obj/effect/decal/cleanable/dirt/dust,
/obj/item/ammo_box/a357,
/obj/item/gun/ballistic/revolver{
	pixel_y = 10;
	pixel_x = -4
	},
/obj/effect/decal/cleanable/wrapping,
/turf/open/misc/sandy_dirt,
/area/lavaland/surface/outdoors)
"Ci" = (
/obj/effect/decal/cleanable/dirt/dust,
/obj/effect/decal/cleanable/dirt/dust,
/obj/effect/decal/cleanable/ash,
/turf/open/misc/sandy_dirt,
/area/lavaland/surface/outdoors)
"Cl" = (
/obj/structure/flora/rock/pile/style_random,
/turf/open/misc/dirt/jungle/wasteland,
/area/lavaland/surface/outdoors)
"CT" = (
/obj/effect/decal/cleanable/dirt/dust,
/obj/effect/decal/cleanable/glass,
/obj/structure/closet/supplypod{
	name = "emergency provisions pod"
	},
/obj/effect/decal/cleanable/dirt,
/turf/open/misc/sandy_dirt,
/area/lavaland/surface/outdoors)
"CZ" = (
/obj/effect/light_emitter/fake_outdoors,
/obj/structure/flora/bush/pointy/style_random,
/turf/open/floor/grass{
	baseturfs = /turf/open/chasm/jungle
	},
/area/lavaland/surface/outdoors)
"DS" = (
/obj/structure/flora/bush/pointy/style_random,
/turf/open/floor/grass{
	baseturfs = /turf/open/chasm/jungle
	},
/area/lavaland/surface/outdoors)
"Ew" = (
/obj/effect/decal/cleanable/dirt/dust,
/obj/effect/decal/cleanable/robot_debris,
/turf/open/floor/grass{
	baseturfs = /turf/open/chasm/jungle
	},
/area/lavaland/surface/outdoors)
"ES" = (
/obj/structure/flora/bush/lavendergrass/style_random,
/turf/open/misc/sandy_dirt,
/area/lavaland/surface/outdoors)
"KX" = (
/obj/effect/decal/cleanable/dirt/dust,
/obj/effect/decal/cleanable/dirt/dust,
/obj/effect/decal/cleanable/dirt/dust,
/obj/effect/decal/cleanable/ash,
/turf/open/misc/sandy_dirt,
/area/lavaland/surface/outdoors)
"LE" = (
/obj/effect/decal/cleanable/oil/slippery,
/obj/structure/reagent_dispensers/fueltank/large,
/turf/open/misc/sandy_dirt,
/area/lavaland/surface/outdoors)
"Nc" = (
/obj/structure/flora/bush/reed/style_random,
/turf/open/water,
/area/lavaland/surface/outdoors)
"Nf" = (
/obj/structure/flora/bush/leafy,
/mob/living/basic/butterfly/lavaland,
/mob/living/basic/butterfly/lavaland,
/turf/open/water,
/area/lavaland/surface/outdoors)
"NY" = (
/turf/open/water,
/area/lavaland/surface/outdoors)
"OX" = (
/obj/structure/flora/rock/style_random,
/turf/open/misc/asteroid/basalt,
/area/lavaland/surface/outdoors)
"PI" = (
/obj/structure/spawner/mining{
	name = "rabbit hole";
	mob_types = list(/mob/living/basic/rabbit);
	desc = "Wabbit season."
	},
/turf/open/floor/grass{
	baseturfs = /turf/open/chasm/jungle
	},
/area/lavaland/surface/outdoors)
"Qa" = (
/turf/open/misc/dirt/dark/station,
/turf/open/misc/sandy_dirt,
/area/lavaland/surface/outdoors)
"QA" = (
/obj/effect/decal/cleanable/dirt/dust,
/obj/item/stack/sheet/iron/fifty{
	pixel_y = 7
	},
/obj/item/stack/sheet/glass/fifty{
	pixel_y = -2
	},
/turf/open/misc/sandy_dirt,
/area/lavaland/surface/outdoors)
"QO" = (
/obj/effect/decal/cleanable/dirt/dust,
/obj/item/pickaxe/mini,
/obj/effect/decal/cleanable/dirt/dust,
/obj/effect/decal/cleanable/glass,
/turf/open/misc/sandy_dirt,
/area/lavaland/surface/outdoors)
"Ru" = (
/obj/structure/flora/bush/leafy,
/turf/open/misc/dirt/jungle/wasteland,
/area/lavaland/surface/outdoors)
"Tt" = (
/turf/open/floor/grass{
	baseturfs = /turf/open/chasm/jungle
	},
/area/lavaland/surface/outdoors)
"TX" = (
/obj/effect/decal/cleanable/oil,
/turf/open/floor/grass{
	baseturfs = /turf/open/chasm/jungle
	},
/area/lavaland/surface/outdoors)
"UJ" = (
/obj/structure/spawner/mining{
	name = "foxhole";
	mob_types = list(/mob/living/basic/pet/fox);
	desc = "You've heard many tales from here."
	},
/turf/open/misc/sandy_dirt,
/area/lavaland/surface/outdoors)
"VB" = (
/obj/effect/decal/cleanable/dirt/dust,
/obj/effect/decal/cleanable/dirt/dust,
/obj/effect/decal/cleanable/wrapping,
/obj/item/circuitboard/machine/autolathe{
	pixel_y = -8
	},
/obj/item/circuitboard/machine/circuit_imprinter{
	pixel_y = -4
	},
/obj/item/circuitboard/machine/flatpacker,
/turf/open/misc/sandy_dirt,
/area/lavaland/surface/outdoors)
"VD" = (
/obj/effect/decal/cleanable/dirt/dust,
/obj/effect/decal/cleanable/wrapping,
/obj/item/storage/box/stockparts/basic{
	pixel_y = 13;
	pixel_x = -1
	},
/obj/item/storage/box/stockparts/basic{
	pixel_y = 3;
	pixel_x = -1
	},
/obj/effect/decal/cleanable/glass,
/turf/open/misc/sandy_dirt,
/area/lavaland/surface/outdoors)
"Wo" = (
/obj/structure/flora/bush/stalky/style_random,
/turf/open/floor/grass{
	baseturfs = /turf/open/chasm/jungle
	},
/area/lavaland/surface/outdoors)
"WA" = (
/obj/effect/decal/cleanable/dirt/dust,
/obj/effect/decal/cleanable/ash/large,
/turf/open/misc/sandy_dirt,
/area/lavaland/surface/outdoors)
"WK" = (
/obj/machinery/power/port_gen/pacman/pre_loaded,
/obj/item/stack/sheet/mineral/plasma/thirty{
	pixel_y = -15;
	pixel_x = -2
	},
/turf/open/misc/sandy_dirt,
/area/lavaland/surface/outdoors)
"XP" = (
/obj/effect/light_emitter/fake_outdoors,
/obj/structure/flora/bush/style_random,
/turf/open/misc/sandy_dirt,
/area/lavaland/surface/outdoors)
"XU" = (
/obj/structure/closet/supplypod{
	name = "emergency provisions pod"
	},
/obj/effect/decal/cleanable/dirt/dust,
/obj/effect/decal/cleanable/dirt/dust,
/obj/effect/decal/cleanable/dirt,
/turf/open/misc/sandy_dirt,
/area/lavaland/surface/outdoors)
"Yw" = (
/obj/structure/flora/bush/leafy,
/turf/open/water,
/area/lavaland/surface/outdoors)
"YQ" = (
/obj/effect/light_emitter/fake_outdoors,
/turf/open/misc/sandy_dirt,
/area/lavaland/surface/outdoors)
"ZX" = (
/obj/structure/flora/bush/large/style_random,
/turf/open/misc/dirt/jungle/wasteland,
/area/lavaland/surface/outdoors)

(1,1,1) = {"
Tt
Tt
Tt
Tt
Tt
Tt
gk
Tt
Tt
Tt
gk
Tt
Tt
Tt
Tt
Tt
Tt
Tt
Tt
Tt
Tt
Tt
Tt
qY
qY
qY
Tt
gk
Tt
Tt
cz
cz
Tt
DS
Tt
gk
Tt
Tt
oe
qY
qY
qY
gk
Tt
Tt
Tt
Tt
gk
qY
qY
"}
(2,1,1) = {"
Tt
gk
oe
Tt
Tt
Tt
Tt
Tt
Tt
oe
Tt
Tt
Tt
Tt
Tt
Tt
oe
Tt
gk
Tt
Tt
qY
qY
qY
qY
qY
qY
zL
qY
qY
zs
cz
qY
qY
qY
wb
qY
qY
qY
zL
qY
qY
qY
qY
wb
qY
qY
qY
qY
qY
"}
(3,1,1) = {"
Tt
Tt
cz
cz
Tt
Tt
up
Tt
Tt
Tt
Tt
Tt
oe
gk
Tt
Tt
Tt
DS
Tt
qY
qY
qY
OX
wb
wb
qY
wb
wb
qY
qY
qY
ES
qY
wb
wb
wb
wb
wb
ES
qY
qY
wb
wb
wb
wb
wb
wb
wb
qY
qY
"}
(4,1,1) = {"
Tt
Tt
cz
cz
Tt
Tt
Tt
gk
Tt
Tt
Tt
Tt
Tt
Tt
Tt
Tt
Tt
cz
cz
zL
qY
qY
wb
jg
jg
wb
wb
wb
wb
wb
wb
wb
wb
wb
jg
jg
vb
wb
wb
OX
wb
wb
wb
jg
jg
jg
jg
wb
wb
Tt
"}
(5,1,1) = {"
Tt
Tt
gk
Wo
Tt
Tt
Tt
Tt
Tt
gk
Tt
Tt
Tt
Tt
up
gk
Tt
cz
cz
qY
qY
wb
wb
jg
jg
jg
jg
jg
jg
wb
wb
jg
jg
jg
jg
jg
jg
wb
wb
wb
wb
wb
jg
jg
jg
jg
wb
wb
qY
Tt
"}
(6,1,1) = {"
gk
Wo
Tt
oe
Tt
Tt
DS
Tt
Tt
Tt
TX
fb
Ew
Tt
Tt
Tt
Tt
Tt
Tt
qY
qY
qY
wb
jg
jg
jg
jg
jg
jg
jg
wb
wb
jg
jg
jg
jg
jg
jg
jg
jg
wb
jg
jg
jg
jg
wb
wb
wb
qY
gk
"}
(7,1,1) = {"
Wo
PI
Tt
Tt
Tt
Tt
Tt
Tt
Tt
Tt
KX
nh
fb
fb
Tt
Tt
Tt
Tt
Tt
Tt
qY
wb
wb
vb
jg
wb
jg
jg
jg
jg
jg
wb
jg
jg
jg
jg
jg
jg
jg
jg
wb
jg
jg
jg
jg
wb
wb
qY
qY
qY
"}
(8,1,1) = {"
Tt
Wo
Tt
Tt
Tt
Tt
Tt
Tt
Tt
fb
oX
rj
mf
Tt
Tt
Tt
Tt
Tt
oe
Tt
qY
wb
wb
wb
wb
wb
jg
jg
jg
jg
jg
jg
jg
jg
jg
jg
jg
jg
jg
jg
wb
wb
wb
jg
jg
wb
ES
qY
zL
qY
"}
(9,1,1) = {"
gk
Tt
oe
Tt
Tt
Tt
Tt
oe
Tt
fb
Ci
eS
bv
kp
Tt
Tt
Tt
Tt
gk
Tt
ES
qY
qY
wb
wb
jg
jg
jg
jg
jg
jg
jg
jg
jg
jg
jg
jg
jg
jg
jg
jg
eF
qY
qY
jg
jg
wb
qY
qY
DS
"}
(10,1,1) = {"
Tt
Tt
Tt
Tt
Tt
Tt
Tt
Tt
Tt
WA
uK
xb
hz
Tt
Tt
Tt
Tt
Tt
Tt
Tt
qY
qY
zL
qY
qY
wb
jg
jg
jg
jg
jg
jg
jg
jg
jg
jg
vb
wb
vb
jg
jg
qY
mF
OX
jg
jg
wb
wb
qY
Tt
"}
(11,1,1) = {"
Tt
Tt
Tt
Tt
Tt
DS
Tt
Tt
qJ
CT
Cb
wW
WK
Tt
Tt
Tt
Tt
Tt
Tt
Tt
qY
qY
qY
wb
OX
wb
wb
jg
jg
jg
jg
jg
jg
jg
jg
vb
wb
qY
wb
eF
jg
OX
zL
jg
jg
jg
wb
wb
YQ
cz
"}
(12,1,1) = {"
Tt
Tt
gk
Tt
Tt
Tt
gk
Tt
Tt
Tt
vG
QO
LE
Tt
Tt
Tt
Tt
Tt
Tt
oe
Tt
qY
qY
wb
wb
wb
jg
jg
jg
jg
jg
jg
jg
jg
jg
OX
qY
kP
ES
wb
jg
jg
jg
jg
jg
vb
wb
wb
YQ
cz
"}
(13,1,1) = {"
Tt
Tt
Tt
Tt
Tt
Tt
oe
Tt
Tt
fb
bT
xn
VB
Tt
Tt
Tt
Tt
gk
Tt
Tt
Tt
qY
qY
wb
wb
jg
jg
jg
jg
jg
jg
jg
jg
jg
jg
eF
wb
ES
vb
wb
wb
wb
wb
wb
wb
wb
wb
wb
qY
gk
"}
(14,1,1) = {"
Tt
Tt
Tt
Tt
Tt
Tt
Tt
Tt
Tt
ky
XU
sd
QA
fb
Tt
DS
Tt
Tt
qY
qY
qY
qY
wb
wb
jg
jg
jg
jg
jg
jg
jg
jg
jg
jg
jg
jg
vb
wb
OX
vb
jg
jg
jg
wb
wb
OX
qY
qY
qY
qY
"}
(15,1,1) = {"
Tt
Tt
Tt
Tt
up
Tt
gk
Tt
Tt
Tt
me
VD
fb
fb
Tt
Tt
qY
qY
zL
qY
qY
wb
wb
wb
jg
jg
jg
jg
jg
jg
jg
jg
jg
jg
jg
jg
jg
jg
jg
jg
jg
jg
jg
jg
wb
wb
qY
zL
qY
qY
"}
(16,1,1) = {"
qY
Tt
cz
cz
qY
gk
Tt
Tt
Tt
Tt
Tt
fb
Tt
Ac
Tt
Tt
Tt
qY
qY
qY
qY
qY
wb
wb
wb
jg
jg
jg
jg
jg
jg
jg
jg
jg
jg
jg
jg
jg
jg
wb
jg
jg
jg
jg
wb
wb
wb
qY
qY
oe
"}
(17,1,1) = {"
qY
qY
cz
cz
qY
qY
Tt
Tt
Tt
Tt
Tt
Tt
Tt
Tt
qY
YQ
cz
Tt
DS
Tt
qY
ES
wb
jg
jg
jg
jg
jg
jg
jg
jg
jg
jg
jg
jg
jg
jg
jg
vb
wb
wb
jg
jg
jg
jg
wb
wb
wb
qY
qY
"}
(18,1,1) = {"
Tt
qY
qY
qY
qY
qY
Tt
Tt
Tt
Tt
gk
Tt
Tt
qY
qY
YQ
cz
oe
Tt
gk
qY
wb
wb
jg
jg
jg
jg
jg
jg
jg
jg
jg
jg
jg
jg
wb
wb
jg
wb
wb
wb
wb
wb
jg
jg
wb
qY
qY
qY
qY
"}
(19,1,1) = {"
qY
qY
qY
ys
qY
qY
qY
Tt
Tt
qY
Tt
Tt
Tt
Tt
Tt
qY
ES
qY
qY
Tt
wb
wb
wb
jg
jg
jg
jg
jg
jg
jg
jg
jg
jg
jg
wb
wb
wb
wb
wb
wb
wb
wb
wb
wb
wb
wb
wb
wb
qY
ES
"}
(20,1,1) = {"
qY
qY
ys
ys
ES
qY
qY
Tt
qY
qY
ES
qY
Tt
Tt
Tt
Tt
qY
qY
Tt
qY
wb
qY
wb
wb
jg
jg
jg
jg
jg
wb
wb
wb
jg
vb
wb
wb
OX
wb
wb
zL
qY
wb
wb
wb
wb
qY
qY
qY
qY
qY
"}
(21,1,1) = {"
ES
ys
ZX
ys
ys
ys
qY
ES
ys
qY
qY
qY
qY
qY
qY
qY
qY
qY
qY
ys
ys
ES
zL
wb
wb
jg
jg
jg
jg
jg
wb
wb
wb
wb
wb
wb
qY
qY
qY
qY
ES
YQ
YQ
Tt
gk
Tt
DS
gk
qY
qY
"}
(22,1,1) = {"
ys
ZX
Ru
ys
ys
ys
ys
ys
ZX
ys
qY
qY
qY
qY
qY
qY
ys
ES
ys
Ru
ZX
ys
wb
wb
vb
wb
jg
jg
jg
jg
jg
wb
wb
wb
wb
ES
qY
qY
qY
oe
gk
cz
cz
Tt
Tt
Tt
oe
Tt
Qa
zW
"}
(23,1,1) = {"
NY
Bs
Nc
gO
NY
NY
ys
ZX
Ru
ZX
ys
ES
qY
qY
ys
ys
ys
ys
ZX
Ru
Nc
Yw
wb
wb
wb
OX
wb
wb
jg
jg
wb
wb
OX
wb
wb
wb
wb
ES
qY
ys
qY
qY
Tt
up
qY
qY
zW
qY
ys
qY
"}
(24,1,1) = {"
NY
NY
vW
NY
NY
NY
NY
Ru
Nc
Nf
ys
ys
ys
ys
ys
NY
ys
NY
NY
vW
Yw
NY
NY
fV
NY
wb
wb
vb
wb
wb
OX
wb
wb
vb
NY
wb
wb
wb
ys
ys
qY
ys
qY
qY
ys
ys
ys
ys
ys
ys
"}
(25,1,1) = {"
NY
NY
NY
NY
Yw
NY
NY
NY
vW
NY
NY
ys
ys
ys
NY
NY
NY
NY
NY
NY
vW
NY
NY
wb
NY
vb
NY
NY
NY
NY
NY
NY
NY
OX
NY
NY
NY
NY
ZX
ZX
Ru
ZX
ys
ys
ys
ys
Yw
NY
ZX
Ru
"}
(26,1,1) = {"
NY
NY
dM
Nc
vW
NY
NY
NY
NY
NY
NY
NY
NY
NY
vW
NY
NY
NY
ZX
Yw
wb
wb
wb
wb
NY
NY
NY
NY
NY
vb
NY
vb
NY
NY
fV
wb
NY
NY
NY
Bs
Nc
NY
NY
NY
Cl
NY
NY
NY
Yw
dm
"}
(27,1,1) = {"
ys
ys
ZX
mr
ZX
NY
NY
NY
ZX
Cl
NY
NY
NY
mr
Nc
Yw
ys
ys
ys
wb
wb
wb
wb
wb
OX
wb
fV
vb
wb
wb
wb
OX
wb
wb
wb
wb
wb
NY
NY
NY
Bs
NY
NY
NY
NY
NY
NY
NY
vW
NY
"}
(28,1,1) = {"
qY
ES
ys
ZX
ys
ys
ys
ys
gO
ys
ys
ys
ZX
Ru
ZX
ys
ys
ys
ys
ys
qY
ES
qY
wb
wb
wb
OX
wb
wb
wb
wb
wb
wb
wb
wb
wb
wb
wb
ys
Cl
NY
NY
vW
NY
NY
NY
NY
NY
NY
NY
"}
(29,1,1) = {"
qY
qY
qY
ys
ys
qY
qY
qY
ys
ES
qY
qY
ys
ZX
ES
qY
qY
qY
ys
qY
qY
qY
qY
ES
wb
wb
wb
wb
jg
jg
jg
wb
wb
ES
qY
wb
wb
wb
wb
ZX
ys
ZX
Ru
zJ
Yw
NY
NY
NY
ZX
NY
"}
(30,1,1) = {"
Tt
Tt
qY
ys
qY
qY
Tt
oe
qY
qY
cz
cz
Tt
Tt
Tt
gk
qY
qY
qY
qY
zL
wb
qY
wb
wb
wb
wb
jg
jg
jg
jg
jg
wb
wb
qY
qY
qY
qY
qY
ys
ES
ys
Ru
ZX
ys
ys
ys
ys
ys
ZX
"}
(31,1,1) = {"
Tt
qY
qY
gk
qY
qY
DS
qY
qY
qY
cz
cz
Tt
Tt
up
Tt
qY
qY
qY
qY
wb
wb
OX
wb
wb
wb
jg
jg
jg
jg
jg
jg
jg
wb
wb
qY
ES
qY
Tt
oe
qY
qY
qY
ys
qY
ES
ys
ys
ys
ys
"}
(32,1,1) = {"
qY
qY
qY
qY
qY
qY
qY
qY
Tt
gk
Tt
Tt
Tt
wb
qY
qY
qY
ES
Tt
Tt
Tt
wb
wb
wb
wb
wb
jg
jg
jg
wb
wb
jg
wb
wb
qY
qY
Tt
Tt
gk
Tt
qY
qY
ES
Tt
gk
qY
qY
qY
ys
ys
"}
(33,1,1) = {"
Tt
Tt
qY
zL
OX
wb
wb
wb
ES
qY
zL
qY
wb
wb
wb
qY
qY
qY
qY
wb
wb
wb
wb
jg
jg
jg
jg
jg
jg
wb
wb
wb
wb
ES
Tt
cz
cz
Tt
Tt
Tt
qY
Tt
Tt
Tt
Tt
qY
YQ
YQ
qY
qY
"}
(34,1,1) = {"
gk
Tt
qY
qY
wb
wb
wb
jg
wb
wb
wb
wb
wb
wb
wb
qY
qY
wb
wb
wb
wb
jg
jg
jg
jg
jg
jg
jg
jg
jg
vb
wb
wb
qY
Tt
cz
cz
Tt
Tt
Tt
Tt
Tt
oe
Tt
DS
Tt
cz
YQ
qY
qY
"}
(35,1,1) = {"
Tt
DS
qY
qY
wb
jg
jg
jg
jg
jg
jg
wb
wb
wb
wb
zL
qY
qY
wb
wb
jg
jg
jg
jg
wb
jg
jg
jg
jg
jg
jg
wb
wb
wb
qY
Tt
Tt
gk
Tt
Tt
Tt
Tt
gk
Tt
Tt
Tt
Tt
Tt
Tt
ES
"}
(36,1,1) = {"
Tt
Tt
qY
wb
wb
wb
jg
jg
jg
jg
jg
jg
jg
wb
wb
wb
wb
wb
wb
jg
jg
jg
jg
jg
wb
wb
wb
jg
jg
jg
jg
jg
wb
qY
qY
oe
Tt
Tt
Tt
Tt
Tt
Tt
Tt
Tt
Tt
Tt
Tt
oe
gk
qY
"}
(37,1,1) = {"
Tt
Tt
oe
qY
ES
wb
wb
jg
jg
jg
jg
jg
jg
wb
wb
wb
wb
wb
wb
jg
jg
wb
wb
wb
wb
bl
wb
wb
wb
jg
jg
jg
wb
zL
qY
qY
Tt
Tt
Tt
oe
gk
Tt
Tt
Tt
Tt
Tt
Tt
gk
Tt
qY
"}
(38,1,1) = {"
Tt
Tt
Tt
qY
qY
wb
wb
jg
jg
jg
jg
jg
jg
jg
jg
vb
wb
jg
jg
jg
jg
wb
wb
zL
ES
qY
ZX
gO
wb
jg
jg
jg
jg
wb
qY
gk
Tt
Tt
Tt
Tt
Tt
DS
Tt
Tt
Tt
Tt
Tt
Tt
Tt
Tt
"}
(39,1,1) = {"
Tt
Tt
Tt
qY
qY
wb
wb
wb
jg
jg
jg
jg
jg
jg
jg
wb
wb
jg
jg
jg
wb
wb
qY
qY
up
tD
ys
ys
wb
wb
jg
jg
jg
wb
qY
Tt
Tt
Tt
Tt
Tt
Tt
Tt
Tt
Tt
Tt
gk
Tt
Tt
Tt
Tt
"}
(40,1,1) = {"
Tt
cz
cz
Tt
qY
qY
wb
wb
wb
jg
jg
jg
jg
jg
wb
wb
wb
wb
wb
wb
wb
qY
qY
Tt
gk
ZX
Cl
wb
wb
wb
jg
jg
jg
wb
wb
qY
Tt
gk
Wo
DS
Tt
cz
cz
Tt
Tt
Tt
Tt
Tt
Tt
Tt
"}
(41,1,1) = {"
Tt
cz
cz
gk
qY
qY
wb
wb
wb
wb
jg
jg
wb
wb
wb
wb
wb
jg
wb
wb
wb
ES
bl
wi
Tt
qY
qY
wb
wb
jg
jg
jg
jg
wb
qY
Tt
Tt
Tt
Tt
Tt
Tt
cz
cz
Tt
Tt
Tt
Tt
Tt
gk
Tt
"}
(42,1,1) = {"
Tt
Tt
Tt
oe
qY
qY
wb
wb
wb
wb
wb
wb
wb
wb
wb
wb
jg
jg
vb
wb
wb
wb
na
qY
zL
bl
wb
wb
wb
jg
jg
jg
wb
wb
qY
Tt
Tt
Wo
Wo
Tt
gk
Tt
Tt
Tt
Tt
DS
Tt
Tt
Tt
Tt
"}
(43,1,1) = {"
Tt
Tt
Tt
qY
qY
zL
wb
wb
jg
jg
jg
jg
jg
jg
jg
jg
jg
jg
jg
wb
wb
wb
wb
wb
wb
wb
wb
wb
wb
jg
jg
jg
wb
zL
qY
Tt
Tt
Tt
oe
Tt
Tt
Tt
Tt
Tt
Tt
Tt
Tt
Tt
Tt
Tt
"}
(44,1,1) = {"
Tt
Tt
DS
qY
qY
wb
wb
jg
jg
jg
jg
jg
jg
jg
jg
jg
jg
jg
jg
jg
jg
jg
jg
wb
wb
jg
jg
jg
jg
jg
jg
jg
wb
wb
qY
oe
Tt
gk
Tt
Tt
Tt
gk
Tt
Tt
Tt
Tt
Tt
Tt
up
Tt
"}
(45,1,1) = {"
Tt
Tt
Tt
qY
ES
wb
jg
jg
jg
jg
jg
jg
jg
jg
jg
jg
jg
jg
jg
jg
jg
jg
jg
jg
jg
jg
jg
jg
jg
jg
jg
jg
jg
wb
qY
Tt
Tt
Tt
Tt
Tt
Tt
Tt
Tt
Tt
gk
Tt
Tt
Tt
Tt
Tt
"}
(46,1,1) = {"
Tt
gk
Tt
qY
wb
wb
jg
jg
jg
jg
jg
jg
jg
wb
wb
jg
jg
jg
jg
jg
jg
jg
jg
jg
jg
jg
jg
jg
jg
jg
jg
jg
wb
wb
qY
cz
cz
Tt
Tt
Tt
Tt
Tt
Tt
Tt
Tt
Tt
cz
cz
Tt
oe
"}
(47,1,1) = {"
Tt
Tt
Tt
Tt
qY
wb
wb
jg
jg
jg
jg
wb
wb
wb
wb
wb
wb
jg
jg
jg
jg
jg
jg
wb
wb
wb
jg
jg
jg
jg
jg
jg
wb
qY
Tt
cz
cz
oe
Tt
gk
Tt
Tt
Tt
Tt
Tt
oe
cz
XP
qY
Tt
"}
(48,1,1) = {"
Tt
Tt
oe
qY
qY
OX
wb
wb
jg
wb
wb
wb
zL
qY
OX
wb
wb
wb
wb
jg
jg
jg
wb
wb
wb
wb
wb
wb
jg
jg
wb
wb
wb
qY
gk
Tt
Tt
Tt
Tt
Tt
Tt
Tt
Tt
Tt
Tt
Tt
UJ
qY
qY
Tt
"}
(49,1,1) = {"
Tt
Tt
Tt
Tt
qY
qY
zL
wb
wb
wb
qY
qY
zs
YQ
qY
qY
wb
ES
wb
wb
wb
wb
wb
qY
zL
qY
qY
wb
wb
wb
wb
wb
OX
qY
oe
Tt
Tt
gk
Tt
Tt
oe
gk
Tt
Tt
Tt
Tt
up
Bm
qY
Tt
"}
(50,1,1) = {"
DS
Tt
Tt
qY
qY
qY
qY
wb
wb
qY
qY
Tt
cz
CZ
Tt
gk
Tt
qY
qY
wb
qY
qY
qY
qY
Tt
oe
qY
qY
wb
wb
ES
qY
qY
zL
Tt
Tt
Tt
Tt
Tt
Tt
Tt
Tt
Tt
Tt
Tt
Tt
Tt
Tt
Tt
Tt
"}
